abru = Antoine Bru <Antoine.Bru@sophia.inria.fr>
afabri = Andreas Fabri <Andreas.Fabri@geometryfactory.com>
akobel = Alexander Kobel <akobel@mpi-inf.mpg.de>
algerbya = Yacine Bouzidi <bouzidi.yacine@gmail.com>
amebarki = Abdelkrim Mebarki <Abdelkrim.Mebarki@sophia.inria.fr>
ameyer = Andreas Meyer <ameyer@mpi-inf.mpg.de>
ameyer = Andreas Meyer <Andreas.Meyer@sophia.inria.fr>
amitgupta = Amit Gupta <amitgupta@cse.iitb.ac.in>
analekta = Costas Tsirogiannis <analekta@gmail.com>
andreasfabri = Andreas Fabri <Andreas.Fabri@geometryfactory.com>
andyslj = Le-Jeng Shiue <Andy.Shiue@gmail.com>
asafpor = Asaf Porat <asafpor@gmail.com>
asm = Pavel Emeliyanenko <asm@mpi-sb.mpg.de>
atsui = Alex Tsui <alextsui05@gmail.com>
avaxman = Amir Vaxman <avaxman@cs.technion.ac.il>
baesken = Matthias Bäsken <Matthias.Baesken@mpi-sb.mpg.de>
balasmic = Michal Kleinbort <michal.balas@gmail.com>
baruchzu = Baruch Zukerman <baruchzu@post.tau.ac.il>
bgalehouse = Ben Galehouse <bgalehouse@spamcop.net>
cbonetto = Carine Bonetto <Carine.Bonetto@sophia.inria.fr>
cdelage = Christophe Delage <Christophe.Delage@sophia.inria.fr>
cgal-web-admin = CGAL Web Admin <cgal-editorial-board@inria.fr>
cggaurav = Gaurav Chandrashekar <gauravc@nus.edu.sg>
cjamin = Clément Jamin <clement.jamin@inria.fr>
cvs2svn = CVS2SVN tool <cgal-develop@inria.fr>
cwerner = Claudia Werner <claudia.werner@inria.fr>
cwormser = Camille Wormser <cwormser@inf.ethz.ch>
danha = Dan Halperin <danha@post.tau.ac.il>
dave = David Millman <David.Millman@sophia.inria.fr>
dboltcheva = Dobrina Boltcheva <Dobrina.Boltcheva@sophia.inria.fr>
dima = Dmitrii V Pasechnik <dima@ntu.edu.sg>
drorata = Dror Atariah <dror.atariah@fu-berlin.de>
drussel = Daniel Russel <drussel@gmail.com>
dtyagi = Devashish Tyagi <devashishrocker@gmail.com>
efif = Efi Fogel <efif@post.tau.ac.il>
elip = Eli Packer <elip@post.tau.ac.il>
eric = Eric Berberich <eric.berberich@cgal.org>
estere = Ester Ezra <estere@post.tau.ac.il>
eug = Eugene Lipovetsky <eug@post.tau.ac.il>
fcacciola = Fernando Cacciola <fernando.cacciola@geometryfactory.com>
fcazals = Frédéric Cazals <Frederic.Cazals@sophia.inria.fr>
fischerk = Kaspar Fischer <fischerk@inf.ethz.ch>
frankda = Tran Kai Frank Da <Frank.Da@sophia.inria.fr>
fransw = Frans Wessendorp <fwessend@iiic.ethz.ch>
frebufat = François Rebufat <Francois.Rebufat@sophia.inria.fr>
gaertner = Bernd Gärtner <gaertner@inf.ethz.ch>
gankit = Ankit Gupta <ankitgupta00@gmail.com>
gdamiand = Guillaume Damiand <guillaume.damiand@liris.cnrs.fr>
geert = Geert-Jan Giezeman <geert@cs.uu.nl>
ggael = Gaël Guennebaud <gael.guennebaud@inria.fr>
glisse = Marc Glisse <Marc.Glisse@inria.fr>
golubevs = Shlomo Golubev <golubevs@post.tau.ac.il>
gorgymic = Michal Meyerovitch <gorgymic@post.tau.ac.il>
granados = Miguel Granados <granados@mpi-sb.mpg.de>
gtzoumas = Georgios Tzoumas <geotz@di.uoa.gr>
guyzucke = Guy Zucker <guyzucke@post.tau.ac.il>
habert = Luc Habert <Luc.Habert@normalesup.org>
hachenb = Peter Hachenberger <hachenberger@mpi-inf.mpg.de>
hanst = Hans Tangelder <hanst@cs.uu.nl>
haranidi = Idit Haran <haranidi@post.tau.ac.il>
helano = Vicente Batista <vicente.helano@gmail.com>
helch = Christian Helbling <helch@vis.ethz.ch>
hemmer = Michael Hemmer <hemmer@mpi-inf.mpg.de>
herrmann = Thomas Herrmann <herrmann@ifor.math.ethz.ch>
hert = Susan Hert <hert@mpi-sb.mpg.de>
hervebronnimann = Hervé Brönnimann <Herve.Bronnimann@sophia.inria.fr>
hoffmann = Michael Hoffmann <hoffmann@inf.ethz.ch>
isuslov = Ilya Suslov <Ilya.Suslov@sophia.inria.fr>
iyaz = Ílker Yaz <ilkeryaz@gmail.com>
jeanmoug = Marc Jeanmougin <Marc.Jeanmougin@sophia.inria.fr>
jflotott = Julia Flötotto <Julia.Flototto@sophia.inria.fr>
jhazebro = Julien Hazebrouck <Julien.Hazebrouck@sophia.inria.fr>
jlenorma = Jacques Le Normand <Jacques.Le.Normand@sophia.inria.fr>
jtournoi = Jane Tournois <Jane.Tournois@sophia.inria.fr>
jzhou = Jin Zhou <zhoujin10@gmail.com>
kacper_rzepecki = Kacper Rzepecki <kacperrzepecki@kacperrzepecki.pl>
kettner = Lutz Kettner <kettner@mpi-sb.mpg.de>
klshi = Kanle Shi <Kanle.Shi@sophia.inria.fr>
leiserow = Eran Leiserowitz <leiserow@post.tau.ac.il>
lrineau = Laurent Rineau <Laurent.Rineau__CGAL@normalesup.org>
lsaboret = Laurent Saboret <Laurent.Saboret@sophia.inria.fr>
marc = Marc Scherfenberg <scherfen@inf.fu-berlin.de>
markblome = Mark Blome <mark.blome@gmail.com>
mbogdanov = Mikhail Bogdanov <bogdanov.mike@gmail.com>
mcaroli = Manuel Caroli <Manuel.Caroli@sophia.inria.fr>
mconstan = Mihaela Constantinescu <Mihaela.Constantinescu@sophia.inria.fr>
mkaravel = Menelaos Karavelas <mkaravel@iacm.forth.gr>
mkerber = Michael Kerber <mkerber@mpi-inf.mpg.de>
mpouget = Marc Pouget <marc.pouget@loria.fr>
mschmitt = Mathieu Schmitt <mathieu.schmitt@inria.fr>
naamamay = Naama Mayer <naamamay@gmail.com>
nicokruithof = Nico Kruithof <Nico@cs.rug.nl>
nmeskini = Naceur Meskini <Naceur.Meskini@sophia.inria.fr>
nsalman = Nader Salman <Nader.Salman@sophia.inria.fr>
odevil = Olivier Devillers <Olivier.Devillers@inria.fr>
olivierrouiller = Olivier Rouiller <Olivier.Rouiller@sophia.inria.fr>
ophirset = Ophir Setter <ophirset@post.tau.ac.il>
orenzalz = Oren Salzman <orenzalz@post.tau.ac.il>
osbild = Ralf Osbild <osbild@mpi-sb.mpg.de>
ovgrig = Ovidiu Grigore <ovgrig@yahoo.com>
palliez = Pierre Alliez <Pierre.Alliez@sophia.inria.fr>
penarand = Luis Peñaranda <penarand@loria.fr>
pivanov = Petar Ivanov <peter.ivanov89@gmail.com>
pgiannop = Panos Giannopoulos <panos@mi.fu-berlin.de>
philaris = Panagiotis Cheilaris <philaris@cs.ntua.gr>
pmachado = Pedro Machado Manhaes de Castro <Pedro.Machado@sophia.inria.fr>
pmemari = Pooran Memari <memari@telecom-paristech.fr>
pmoeller = Philipp Möller <Philipp.Moeller@geometryfactory.com>
rahul = Rahul Ray <rahul@mpi-sb.mpg.de>
rchaine = Raphaëlle Chaine <raphaelle.chaine@liris.cnrs.fr>
reichel = Joachim Reichel <joachim.reichel@gmx.de>
rlhemsley = Ross Hemsley <Ross.Hemsley@inria.fr>
rozapoga = Roza Pogalnikova <rozapoga@post.tau.ac.il>
rschindl = Ralf Schindlbeck <rschindl@mpi-inf.mpg.de>
rursu = Radu Ursu <Radu.Ursu@sophia.inria.fr>
sabath = Niv Sabath <sabath@post.tau.ac.il>
sccode = Fei (Sophie) Che <che.sophie@gmail.com>
seel = Michael Seel <seel@mpi-sb.mpg.de>
sgiraudo = Simon Giraudot <simon.giraudot@inria.fr>
shaihi = Shai Hirsch <shaihi@post.tau.ac.il>
shornus = Samuel Hornus <Samuel.Hornus@sophia.inria.fr>
singler = Johannes Singler <singler@ira.uka.de>
slimbach = Sebastian Limbach <slimbach@mpi-inf.mpg.de>
sloriot = Sébastien Loriot <sloriot.ml@gmail.com>
soudot = Steve Oudot <Steve.Oudot@sophia.inria.fr>
spion = Sylvain Pion <Sylvain.Pion@sophia.inria.fr>
spostoll = Stéphane Postollec <Stephane.Postollec@sophia.inria.fr>
sradhak = Sandhyaa Radhakrishnan <sandhyaa1990@gmail.com>
sschaeff = Sarah Schäffer <sschaeff@mpi-sb.mpg.de>
stayeb = Stéphane Tayeb <Stephane.Tayeb@sophia.inria.fr>
sven = Sven Schönherr <sven@inf.ethz.ch>
talizvi = Tali Zvi <talizvi@post.tau.ac.il>
teillaud = Monique Teillaud <Monique.Teillaud@sophia.inria.fr>
tgeorgiou = Teo Georgiou <georgiou.teo@gmail.com>
trung = Trung Nguyen <ttnguyen@sophia.inria.fr>
vfisikop = Vissarion Fisikopoulos <vfisikop@di.uoa.gr>
vgagrani = Vinayak Gagrani <gagrani.vinayak@gmail.com>
vlopez = Victor Lopez <valv29@gmail.com>
wein = Ron Wein <wein@post.tau.ac.il>
wenzlaff = Patrick Wenzlaff <wenzlaff@mpi-inf.mpg.de>
ybrise = Yves Brise <ybrise@inf.ethz.ch>
yuchen = Yuanmi Chen <chenymi@gmail.com>
yvinec = Mariette Yvinec <Mariette.Yvinec@sophia.inria.fr>
yzju = Yin Xu <yinxu.zju@gmail.com>
